########
#      #
# . $. #
#  $@  #
#      #
########