#######
#--+--#
#-***-#
#-$.$-#
#-$.$-#
#--.--#
#######