#############
#---######--#
#--------$--#
##-#######--#
#--$-$-$-#$##
#--#....+---#
#--######---#
#############